NO textures/Stone3.xpm
SO textures/stone.xpm
WE textures/mur1.xpm
EA textures/metal.xpm

F 220,100,0
C 225,30,0

11111111111111
10000000000001
11111100111111
11111100111111
111111N0111111
11111100111111
11111100111111
11111111111111