NO textures/barrel.xpm
SO textures/stone.xpm
WE textures/grass.xpm
EA textures/metal.xpm

F 220,100,0
C 225,30,0

11111111111111
10000000000001
11111100111111
      11
11111100111111
1100000N111111
11111010111111
11111000111111
11111111111111